"filename", "language", "TypeScript", "Vue", "SCSS", "XML", "JSON", "comment", "blank", "total"
"e:\backWorkProject\backWork\src\App.vue", "Vue", 0, 13, 0, 0, 0, 0, 2, 15
"e:\backWorkProject\backWork\src\api\acl\menu\index.ts", "TypeScript", 19, 0, 0, 0, 0, 8, 3, 30
"e:\backWorkProject\backWork\src\api\acl\menu\type.ts", "TypeScript", 30, 0, 0, 0, 0, 4, 2, 36
"e:\backWorkProject\backWork\src\api\acl\role\index.ts", "TypeScript", 29, 0, 0, 0, 0, 13, 2, 44
"e:\backWorkProject\backWork\src\api\acl\role\type.ts", "TypeScript", 46, 0, 0, 0, 0, 5, 4, 55
"e:\backWorkProject\backWork\src\api\acl\user\index.ts", "TypeScript", 35, 0, 0, 0, 0, 16, 1, 52
"e:\backWorkProject\backWork\src\api\acl\user\type.ts", "TypeScript", 43, 0, 0, 0, 0, 8, 3, 54
"e:\backWorkProject\backWork\src\api\employee\index.ts", "TypeScript", 41, 0, 0, 0, 0, 9, 9, 59
"e:\backWorkProject\backWork\src\api\employee\type.ts", "TypeScript", 53, 0, 0, 0, 0, 21, 5, 79
"e:\backWorkProject\backWork\src\api\fcategory\index.ts", "TypeScript", 52, 0, 0, 0, 0, 0, 8, 60
"e:\backWorkProject\backWork\src\api\fcategory\type.ts", "TypeScript", 20, 0, 0, 0, 0, 15, 4, 39
"e:\backWorkProject\backWork\src\api\index.ts", "TypeScript", 10, 0, 0, 0, 0, 0, 2, 12
"e:\backWorkProject\backWork\src\api\orders\index.ts", "TypeScript", 68, 0, 0, 0, 0, 4, 8, 80
"e:\backWorkProject\backWork\src\api\orders\type.ts", "TypeScript", 78, 0, 0, 0, 0, 189, 5, 272
"e:\backWorkProject\backWork\src\api\product\attr\index.ts", "TypeScript", 37, 0, 0, 0, 0, 12, 4, 53
"e:\backWorkProject\backWork\src\api\product\attr\type.ts", "TypeScript", 66, 0, 0, 0, 0, 2, 10, 78
"e:\backWorkProject\backWork\src\api\product\sku\index.ts", "TypeScript", 30, 0, 0, 0, 0, 6, 6, 42
"e:\backWorkProject\backWork\src\api\product\sku\type.ts", "TypeScript", 72, 0, 0, 0, 0, 0, 8, 80
"e:\backWorkProject\backWork\src\api\product\spu\index.ts", "TypeScript", 58, 0, 0, 0, 0, 17, 16, 91
"e:\backWorkProject\backWork\src\api\product\spu\type.ts", "TypeScript", 154, 0, 0, 0, 0, 4, 18, 176
"e:\backWorkProject\backWork\src\api\product\trademark\index.ts", "TypeScript", 38, 0, 0, 0, 0, 14, 7, 59
"e:\backWorkProject\backWork\src\api\product\trademark\type.ts", "TypeScript", 33, 0, 0, 0, 0, 1, 3, 37
"e:\backWorkProject\backWork\src\api\production\attr\index.ts", "TypeScript", 59, 0, 0, 0, 0, 13, 8, 80
"e:\backWorkProject\backWork\src\api\production\attr\type.ts", "TypeScript", 15, 0, 0, 0, 0, 24, 4, 43
"e:\backWorkProject\backWork\src\api\production\sku\index.ts", "TypeScript", 46, 0, 0, 0, 0, 0, 10, 56
"e:\backWorkProject\backWork\src\api\production\sku\type.ts", "TypeScript", 43, 0, 0, 0, 0, 66, 6, 115
"e:\backWorkProject\backWork\src\api\production\spu\index.ts", "TypeScript", 50, 0, 0, 0, 0, 0, 8, 58
"e:\backWorkProject\backWork\src\api\production\spu\type.ts", "TypeScript", 55, 0, 0, 0, 0, 69, 10, 134
"e:\backWorkProject\backWork\src\api\scategory\index.ts", "TypeScript", 50, 0, 0, 0, 0, 3, 7, 60
"e:\backWorkProject\backWork\src\api\scategory\type.ts", "TypeScript", 11, 0, 0, 0, 0, 15, 1, 27
"e:\backWorkProject\backWork\src\api\statistics\index.ts", "TypeScript", 46, 0, 0, 0, 0, 0, 3, 49
"e:\backWorkProject\backWork\src\api\statistics\type.ts", "TypeScript", 25, 0, 0, 0, 0, 51, 4, 80
"e:\backWorkProject\backWork\src\api\user\index.ts", "TypeScript", 16, 0, 0, 0, 0, 6, 3, 25
"e:\backWorkProject\backWork\src\api\user\type.ts", "TypeScript", 21, 0, 0, 0, 0, 5, 3, 29
"e:\backWorkProject\backWork\src\assets\icons\copyright.svg", "XML", 0, 0, 0, 1, 0, 0, 0, 1
"e:\backWorkProject\backWork\src\assets\icons\exit-full.svg", "XML", 0, 0, 0, 1, 0, 0, 0, 1
"e:\backWorkProject\backWork\src\assets\icons\full-screen.svg", "XML", 0, 0, 0, 1, 0, 0, 0, 1
"e:\backWorkProject\backWork\src\assets\icons\home.svg", "XML", 0, 0, 0, 1, 0, 0, 0, 1
"e:\backWorkProject\backWork\src\assets\icons\loading.svg", "XML", 0, 0, 0, 1, 0, 0, 0, 1
"e:\backWorkProject\backWork\src\assets\icons\lock.svg", "XML", 0, 0, 0, 1, 0, 0, 0, 1
"e:\backWorkProject\backWork\src\assets\icons\logout.svg", "XML", 0, 0, 0, 1, 0, 0, 0, 1
"e:\backWorkProject\backWork\src\assets\icons\phone.svg", "XML", 0, 0, 0, 1, 0, 0, 0, 1
"e:\backWorkProject\backWork\src\assets\icons\refresh.svg", "XML", 0, 0, 0, 1, 0, 0, 0, 1
"e:\backWorkProject\backWork\src\assets\icons\welcome.svg", "XML", 0, 0, 0, 176, 0, 0, 1, 177
"e:\backWorkProject\backWork\src\components\Category\index.vue", "Vue", 0, 108, 0, 0, 0, 0, 7, 115
"e:\backWorkProject\backWork\src\components\HeadLable\index.vue", "Vue", 0, 89, 0, 0, 0, 0, 12, 101
"e:\backWorkProject\backWork\src\components\InputAutoComplete\index.vue", "Vue", 0, 48, 0, 0, 0, 1, 6, 55
"e:\backWorkProject\backWork\src\components\Svgicon\index.vue", "Vue", 0, 30, 0, 0, 0, 2, 4, 36
"e:\backWorkProject\backWork\src\components\index.ts", "TypeScript", 14, 0, 0, 0, 0, 7, 3, 24
"e:\backWorkProject\backWork\src\directive\has.ts", "TypeScript", 11, 0, 0, 0, 0, 2, 2, 15
"e:\backWorkProject\backWork\src\layout\index.vue", "Vue", 0, 105, 0, 0, 0, 6, 9, 120
"e:\backWorkProject\backWork\src\layout\logo\index.vue", "Vue", 0, 23, 0, 0, 0, 0, 2, 25
"e:\backWorkProject\backWork\src\layout\main\index.vue", "Vue", 0, 49, 0, 0, 0, 2, 3, 54
"e:\backWorkProject\backWork\src\layout\menu\index.vue", "Vue", 0, 68, 0, 0, 0, 4, 6, 78
"e:\backWorkProject\backWork\src\layout\tabbar\index.vue", "Vue", 0, 49, 0, 0, 0, 1, 2, 52
"e:\backWorkProject\backWork\src\layout\tabbar\left_tabbar\index.vue", "Vue", 0, 35, 0, 0, 0, 5, 5, 45
"e:\backWorkProject\backWork\src\layout\tabbar\right_tabbar\index.vue", "Vue", 0, 141, 0, 0, 0, 2, 8, 151
"e:\backWorkProject\backWork\src\main.ts", "TypeScript", 22, 0, 0, 0, 0, 9, 2, 33
"e:\backWorkProject\backWork\src\perimissiion.ts", "TypeScript", 43, 0, 0, 0, 0, 29, 5, 77
"e:\backWorkProject\backWork\src\router\index.ts", "TypeScript", 13, 0, 0, 0, 0, 2, 3, 18
"e:\backWorkProject\backWork\src\router\routes.ts", "TypeScript", 244, 0, 0, 0, 0, 59, 4, 307
"e:\backWorkProject\backWork\src\setting.ts", "TypeScript", 5, 0, 0, 0, 0, 1, 1, 7
"e:\backWorkProject\backWork\src\store\index.ts", "TypeScript", 5, 0, 0, 0, 0, 3, 1, 9
"e:\backWorkProject\backWork\src\store\modules\attr.ts", "TypeScript", 48, 0, 0, 0, 0, 2, 2, 52
"e:\backWorkProject\backWork\src\store\modules\category.ts", "TypeScript", 56, 0, 0, 0, 0, 10, 3, 69
"e:\backWorkProject\backWork\src\store\modules\setting.ts", "TypeScript", 10, 0, 0, 0, 0, 2, 2, 14
"e:\backWorkProject\backWork\src\store\modules\sku.ts", "TypeScript", 48, 0, 0, 0, 0, 2, 2, 52
"e:\backWorkProject\backWork\src\store\modules\spu.ts", "TypeScript", 38, 0, 0, 0, 0, 5, 3, 46
"e:\backWorkProject\backWork\src\store\modules\user.ts", "TypeScript", 58, 0, 0, 0, 0, 44, 9, 111
"e:\backWorkProject\backWork\src\store\types\type.ts", "TypeScript", 18, 0, 0, 0, 0, 1, 4, 23
"e:\backWorkProject\backWork\src\styles\index.scss", "SCSS", 0, 0, 12, 0, 0, 1, 3, 16
"e:\backWorkProject\backWork\src\styles\reset.scss", "SCSS", 0, 0, 164, 0, 0, 5, 21, 190
"e:\backWorkProject\backWork\src\styles\variable.scss", "SCSS", 0, 0, 5, 0, 0, 6, 4, 15
"e:\backWorkProject\backWork\src\utils\request.ts", "TypeScript", 47, 0, 0, 0, 0, 15, 5, 67
"e:\backWorkProject\backWork\src\utils\request2.ts", "TypeScript", 38, 0, 0, 0, 0, 6, 2, 46
"e:\backWorkProject\backWork\src\utils\time.ts", "TypeScript", 14, 0, 0, 0, 0, 2, 1, 17
"e:\backWorkProject\backWork\src\utils\token.ts", "TypeScript", 9, 0, 0, 0, 0, 3, 1, 13
"e:\backWorkProject\backWork\src\views\404\index.vue", "Vue", 0, 10, 0, 0, 0, 1, 2, 13
"e:\backWorkProject\backWork\src\views\ad\permission\index.vue", "Vue", 0, 163, 0, 0, 0, 3, 6, 172
"e:\backWorkProject\backWork\src\views\ad\roler\index.vue", "Vue", 0, 357, 0, 0, 0, 4, 10, 371
"e:\backWorkProject\backWork\src\views\ad\user\index.vue", "Vue", 0, 489, 0, 0, 0, 7, 5, 501
"e:\backWorkProject\backWork\src\views\employee\addEmployee.vue", "Vue", 0, 323, 0, 0, 0, 9, 18, 350
"e:\backWorkProject\backWork\src\views\employee\index.vue", "Vue", 0, 217, 0, 0, 0, 2, 13, 232
"e:\backWorkProject\backWork\src\views\home\index.vue", "Vue", 0, 57, 0, 0, 0, 0, 7, 64
"e:\backWorkProject\backWork\src\views\login\index.vue", "Vue", 0, 162, 0, 0, 0, 0, 11, 173
"e:\backWorkProject\backWork\src\views\operation\index.vue", "Vue", 0, 264, 0, 0, 0, 0, 7, 271
"e:\backWorkProject\backWork\src\views\orders\index.vue", "Vue", 0, 1141, 0, 0, 0, 8, 47, 1196
"e:\backWorkProject\backWork\src\views\product\FCategory\index.vue", "Vue", 0, 355, 0, 0, 0, 4, 19, 378
"e:\backWorkProject\backWork\src\views\product\SCategory\index.vue", "Vue", 0, 367, 0, 0, 0, 4, 18, 389
"e:\backWorkProject\backWork\src\views\product\attr\attrCategory.vue", "Vue", 0, 113, 0, 0, 0, 0, 11, 124
"e:\backWorkProject\backWork\src\views\product\attr\index.vue", "Vue", 0, 384, 0, 0, 0, 73, 18, 475
"e:\backWorkProject\backWork\src\views\product\sku\index.vue", "Vue", 0, 340, 0, 0, 0, 0, 18, 358
"e:\backWorkProject\backWork\src\views\product\sku\skuCategory.vue", "Vue", 0, 113, 0, 0, 0, 0, 11, 124
"e:\backWorkProject\backWork\src\views\product\sku\skuForm.vue", "Vue", 0, 218, 0, 0, 0, 0, 20, 238
"e:\backWorkProject\backWork\src\views\product\spu\index.vue", "Vue", 0, 359, 0, 0, 0, 0, 27, 386
"e:\backWorkProject\backWork\src\views\product\spu\skuForm.vue", "Vue", 0, 235, 0, 0, 0, 0, 15, 250
"e:\backWorkProject\backWork\src\views\product\spu\spuCategory.vue", "Vue", 0, 88, 0, 0, 0, 0, 10, 98
"e:\backWorkProject\backWork\src\views\product\spu\spuForm.vue", "Vue", 0, 328, 0, 0, 0, 88, 27, 443
"e:\backWorkProject\backWork\src\views\product\trademark\index.vue", "Vue", 0, 362, 0, 0, 0, 4, 25, 391
"e:\backWorkProject\backWork\src\views\screen\components\age\index.vue", "Vue", 0, 94, 0, 0, 0, 0, 4, 98
"e:\backWorkProject\backWork\src\views\screen\components\counter\index.vue", "Vue", 0, 116, 0, 0, 0, 0, 10, 126
"e:\backWorkProject\backWork\src\views\screen\components\line\index.vue", "Vue", 0, 96, 0, 0, 0, 0, 5, 101
"e:\backWorkProject\backWork\src\views\screen\components\map\china.json", "JSON", 0, 0, 0, 0, 27324, 0, 1, 27325
"e:\backWorkProject\backWork\src\views\screen\components\map\index.vue", "Vue", 0, 88, 0, 0, 0, 0, 5, 93
"e:\backWorkProject\backWork\src\views\screen\components\rank\index.vue", "Vue", 0, 118, 0, 0, 0, 0, 4, 122
"e:\backWorkProject\backWork\src\views\screen\components\sex\index.vue", "Vue", 0, 124, 0, 0, 0, 0, 5, 129
"e:\backWorkProject\backWork\src\views\screen\components\top\index.vue", "Vue", 0, 93, 0, 0, 0, 0, 10, 103
"e:\backWorkProject\backWork\src\views\screen\components\tourist\index.vue", "Vue", 0, 106, 0, 0, 0, 0, 8, 114
"e:\backWorkProject\backWork\src\views\screen\components\year\index.vue", "Vue", 0, 73, 0, 0, 0, 0, 6, 79
"e:\backWorkProject\backWork\src\views\screen\index.vue", "Vue", 0, 120, 0, 0, 0, 1, 12, 133
"e:\backWorkProject\backWork\src\views\statistic\totaldata\component\moneyStatistic.vue", "Vue", 0, 67, 0, 0, 0, 0, 9, 76
"e:\backWorkProject\backWork\src\views\statistic\totaldata\component\orderStatistic.vue", "Vue", 0, 74, 0, 0, 0, 0, 6, 80
"e:\backWorkProject\backWork\src\views\statistic\totaldata\component\skuTop10.vue", "Vue", 0, 68, 0, 0, 0, 0, 3, 71
"e:\backWorkProject\backWork\src\views\statistic\totaldata\component\spuTop10.vue", "Vue", 0, 68, 0, 0, 0, 0, 4, 72
"e:\backWorkProject\backWork\src\views\statistic\totaldata\component\top10.vue", "Vue", 0, 68, 0, 0, 0, 0, 2, 70
"e:\backWorkProject\backWork\src\views\statistic\totaldata\component\userStatistic.vue", "Vue", 0, 67, 0, 0, 0, 0, 6, 73
"e:\backWorkProject\backWork\src\views\statistic\totaldata\index.vue", "Vue", 0, 256, 0, 0, 0, 0, 25, 281
"e:\backWorkProject\backWork\src\vite-env.d.ts", "TypeScript", 0, 0, 0, 0, 0, 1, 1, 2
"Total", "-", 2190, 8899, 181, 185, 27324, 1048, 816, 40643