"filename", "language", "TypeScript", "Vue", "SCSS", "XML", "comment", "blank", "total"
"d:\OneDrive\桌面\vue3-admin-template\vue3-admin-template\src\App.vue", "Vue", 0, 13, 0, 0, 0, 2, 15
"d:\OneDrive\桌面\vue3-admin-template\vue3-admin-template\src\api\product\attr\index.ts", "TypeScript", 37, 0, 0, 0, 10, 4, 51
"d:\OneDrive\桌面\vue3-admin-template\vue3-admin-template\src\api\product\attr\type.ts", "TypeScript", 66, 0, 0, 0, 2, 10, 78
"d:\OneDrive\桌面\vue3-admin-template\vue3-admin-template\src\api\product\spu\index.ts", "TypeScript", 33, 0, 0, 0, 6, 7, 46
"d:\OneDrive\桌面\vue3-admin-template\vue3-admin-template\src\api\product\spu\type.ts", "TypeScript", 73, 0, 0, 0, 3, 11, 87
"d:\OneDrive\桌面\vue3-admin-template\vue3-admin-template\src\api\product\trademark\index.ts", "TypeScript", 38, 0, 0, 0, 14, 7, 59
"d:\OneDrive\桌面\vue3-admin-template\vue3-admin-template\src\api\product\trademark\type.ts", "TypeScript", 33, 0, 0, 0, 1, 3, 37
"d:\OneDrive\桌面\vue3-admin-template\vue3-admin-template\src\api\user\index.ts", "TypeScript", 16, 0, 0, 0, 6, 3, 25
"d:\OneDrive\桌面\vue3-admin-template\vue3-admin-template\src\api\user\type.ts", "TypeScript", 21, 0, 0, 0, 5, 3, 29
"d:\OneDrive\桌面\vue3-admin-template\vue3-admin-template\src\assets\icons\copyright.svg", "XML", 0, 0, 0, 1, 0, 0, 1
"d:\OneDrive\桌面\vue3-admin-template\vue3-admin-template\src\assets\icons\exit-full.svg", "XML", 0, 0, 0, 1, 0, 0, 1
"d:\OneDrive\桌面\vue3-admin-template\vue3-admin-template\src\assets\icons\full-screen.svg", "XML", 0, 0, 0, 1, 0, 0, 1
"d:\OneDrive\桌面\vue3-admin-template\vue3-admin-template\src\assets\icons\home.svg", "XML", 0, 0, 0, 1, 0, 0, 1
"d:\OneDrive\桌面\vue3-admin-template\vue3-admin-template\src\assets\icons\loading.svg", "XML", 0, 0, 0, 1, 0, 0, 1
"d:\OneDrive\桌面\vue3-admin-template\vue3-admin-template\src\assets\icons\lock.svg", "XML", 0, 0, 0, 1, 0, 0, 1
"d:\OneDrive\桌面\vue3-admin-template\vue3-admin-template\src\assets\icons\logout.svg", "XML", 0, 0, 0, 1, 0, 0, 1
"d:\OneDrive\桌面\vue3-admin-template\vue3-admin-template\src\assets\icons\phone.svg", "XML", 0, 0, 0, 1, 0, 0, 1
"d:\OneDrive\桌面\vue3-admin-template\vue3-admin-template\src\assets\icons\refresh.svg", "XML", 0, 0, 0, 1, 0, 0, 1
"d:\OneDrive\桌面\vue3-admin-template\vue3-admin-template\src\assets\icons\welcome.svg", "XML", 0, 0, 0, 176, 0, 1, 177
"d:\OneDrive\桌面\vue3-admin-template\vue3-admin-template\src\components\Category\index.vue", "Vue", 0, 108, 0, 0, 0, 7, 115
"d:\OneDrive\桌面\vue3-admin-template\vue3-admin-template\src\components\Svgicon\index.vue", "Vue", 0, 30, 0, 0, 2, 4, 36
"d:\OneDrive\桌面\vue3-admin-template\vue3-admin-template\src\components\index.ts", "TypeScript", 14, 0, 0, 0, 7, 3, 24
"d:\OneDrive\桌面\vue3-admin-template\vue3-admin-template\src\layout\index.vue", "Vue", 0, 105, 0, 0, 6, 9, 120
"d:\OneDrive\桌面\vue3-admin-template\vue3-admin-template\src\layout\logo\index.vue", "Vue", 0, 23, 0, 0, 0, 2, 25
"d:\OneDrive\桌面\vue3-admin-template\vue3-admin-template\src\layout\main\index.vue", "Vue", 0, 51, 0, 0, 2, 2, 55
"d:\OneDrive\桌面\vue3-admin-template\vue3-admin-template\src\layout\menu\index.vue", "Vue", 0, 70, 0, 0, 4, 6, 80
"d:\OneDrive\桌面\vue3-admin-template\vue3-admin-template\src\layout\tabbar\index.vue", "Vue", 0, 49, 0, 0, 1, 2, 52
"d:\OneDrive\桌面\vue3-admin-template\vue3-admin-template\src\layout\tabbar\left_tabbar\index.vue", "Vue", 0, 35, 0, 0, 5, 5, 45
"d:\OneDrive\桌面\vue3-admin-template\vue3-admin-template\src\layout\tabbar\right_tabbar\index.vue", "Vue", 0, 84, 0, 0, 2, 5, 91
"d:\OneDrive\桌面\vue3-admin-template\vue3-admin-template\src\main.ts", "TypeScript", 19, 0, 0, 0, 5, 1, 25
"d:\OneDrive\桌面\vue3-admin-template\vue3-admin-template\src\perimissiion.ts", "TypeScript", 42, 0, 0, 0, 24, 6, 72
"d:\OneDrive\桌面\vue3-admin-template\vue3-admin-template\src\router\index.ts", "TypeScript", 13, 0, 0, 0, 2, 3, 18
"d:\OneDrive\桌面\vue3-admin-template\vue3-admin-template\src\router\routes.ts", "TypeScript", 158, 0, 0, 0, 10, 2, 170
"d:\OneDrive\桌面\vue3-admin-template\vue3-admin-template\src\setting.ts", "TypeScript", 5, 0, 0, 0, 1, 1, 7
"d:\OneDrive\桌面\vue3-admin-template\vue3-admin-template\src\store\index.ts", "TypeScript", 5, 0, 0, 0, 3, 1, 9
"d:\OneDrive\桌面\vue3-admin-template\vue3-admin-template\src\store\modules\category.ts", "TypeScript", 56, 0, 0, 0, 10, 3, 69
"d:\OneDrive\桌面\vue3-admin-template\vue3-admin-template\src\store\modules\setting.ts", "TypeScript", 10, 0, 0, 0, 2, 2, 14
"d:\OneDrive\桌面\vue3-admin-template\vue3-admin-template\src\store\modules\user.ts", "TypeScript", 56, 0, 0, 0, 19, 3, 78
"d:\OneDrive\桌面\vue3-admin-template\vue3-admin-template\src\store\types\type.ts", "TypeScript", 7, 0, 0, 0, 1, 2, 10
"d:\OneDrive\桌面\vue3-admin-template\vue3-admin-template\src\styles\index.scss", "SCSS", 0, 0, 12, 0, 1, 3, 16
"d:\OneDrive\桌面\vue3-admin-template\vue3-admin-template\src\styles\reset.scss", "SCSS", 0, 0, 164, 0, 5, 21, 190
"d:\OneDrive\桌面\vue3-admin-template\vue3-admin-template\src\styles\variable.scss", "SCSS", 0, 0, 5, 0, 6, 4, 15
"d:\OneDrive\桌面\vue3-admin-template\vue3-admin-template\src\utils\request.ts", "TypeScript", 47, 0, 0, 0, 15, 5, 67
"d:\OneDrive\桌面\vue3-admin-template\vue3-admin-template\src\utils\time.ts", "TypeScript", 14, 0, 0, 0, 2, 1, 17
"d:\OneDrive\桌面\vue3-admin-template\vue3-admin-template\src\utils\token.ts", "TypeScript", 9, 0, 0, 0, 3, 1, 13
"d:\OneDrive\桌面\vue3-admin-template\vue3-admin-template\src\views\404\index.vue", "Vue", 0, 5, 0, 0, 0, 2, 7
"d:\OneDrive\桌面\vue3-admin-template\vue3-admin-template\src\views\ad\permission\index.vue", "Vue", 0, 5, 0, 0, 0, 2, 7
"d:\OneDrive\桌面\vue3-admin-template\vue3-admin-template\src\views\ad\roler\index.vue", "Vue", 0, 5, 0, 0, 0, 2, 7
"d:\OneDrive\桌面\vue3-admin-template\vue3-admin-template\src\views\ad\user\index.vue", "Vue", 0, 16, 0, 0, 0, 3, 19
"d:\OneDrive\桌面\vue3-admin-template\vue3-admin-template\src\views\home\index.vue", "Vue", 0, 13, 0, 0, 0, 5, 18
"d:\OneDrive\桌面\vue3-admin-template\vue3-admin-template\src\views\login\index.vue", "Vue", 0, 158, 0, 0, 0, 11, 169
"d:\OneDrive\桌面\vue3-admin-template\vue3-admin-template\src\views\product\attr\index.vue", "Vue", 0, 285, 0, 0, 1, 13, 299
"d:\OneDrive\桌面\vue3-admin-template\vue3-admin-template\src\views\product\sku\index.vue", "Vue", 0, 7, 0, 0, 0, 2, 9
"d:\OneDrive\桌面\vue3-admin-template\vue3-admin-template\src\views\product\spu\index.vue", "Vue", 0, 157, 0, 0, 0, 9, 166
"d:\OneDrive\桌面\vue3-admin-template\vue3-admin-template\src\views\product\spu\skuForm.vue", "Vue", 0, 5, 0, 0, 0, 3, 8
"d:\OneDrive\桌面\vue3-admin-template\vue3-admin-template\src\views\product\spu\spuForm.vue", "Vue", 0, 139, 0, 0, 0, 11, 150
"d:\OneDrive\桌面\vue3-admin-template\vue3-admin-template\src\views\product\trademark\index.vue", "Vue", 0, 359, 0, 0, 4, 25, 388
"d:\OneDrive\桌面\vue3-admin-template\vue3-admin-template\src\views\screen\index.vue", "Vue", 0, 5, 0, 0, 0, 2, 7
"d:\OneDrive\桌面\vue3-admin-template\vue3-admin-template\src\vite-env.d.ts", "TypeScript", 0, 0, 0, 0, 1, 1, 2
"Total", "-", 772, 1727, 181, 185, 191, 246, 3302